    0      1      1      0     0     1
    0      2      2      0     0     2
    1      1      3      0     0     3
    1      2      4      0     0     4
    2      1      5      0     0     5
