    0      0      0     0     1
    1     -1      0     0     2
    1      0      0     0     3
    1      1      0     0     4
    2     -2      0     0     5
    2     -1      0     0     6
    2      0      0     0     7
    2      1      0     0     8
    2      2      0     0     9
