    0      0      0     1     1
    1     -1      0     1     2
    1      0      0     1     3
    1      1      0     1     4
    2     -2      0     1     5
    2     -1      0     1     6
    2      0      0     1     7
    2      1      0     1     8
    2      2      0     1     9
