    0      0      0     0     1
    0      0      0     1     2
    1     -1      0     0     3
    1     -1      0     1     4
    1      0      0     0     5
    1      0      0     1     6
    1      1      0     0     7
    1      1      0     1     8
