    0      0      0     0     1
    0      0      0     1     2
    0      0      0     2     3
    0      0      1     0     4
    0      0      1     1     5
    0      0      1     2     6
    0      0      2     0     7
    0      0      2     1     8
    0      0      2     2     9
    0      0      3     1    10
    0      0      3     2    11
