    0      0      0     0     1
    0      0      0     1     2
    0      0      0     2     3
    1     -1      0     0     4
    1     -1      0     1     5
    1     -1      0     2     6
    1      0      0     0     7
    1      0      0     1     8
    1      0      0     2     9
    1      1      0     0    10
    1      1      0     1    11
    1      1      0     2    12
