    0      0      0     0     1
    0      0      0     1     2
    0      0      0     2     3
    0      0      0     3     4
    0      0      0     4     5
    0      0      0     5     6
    0      0      0     6     7
    0      0      1     1     8
    0      0      1     2     9
    0      0      1     3    10
    0      0      1     4    11
    0      0      1     5    12
    0      0      1     6    13
