    0      1      1      0     0     1
    0      2      2      0     0     2
    0      3      3      0     0     3
    1      1      4      0     0     4
    1      2      5      0     0     5
    1      3      6      0     0     6
    2      1      7      0     0     7
    2      2      8      0     0     8
